acehole	l
agaeki	w
ajmiles	w
Al-Poc	w
Antz	l
alskdj	x
Asad	l
Fyorl	l
Mogmiester	w
Amorya	m
Banana	l
benji	l
bma	l
BigG	x
bma	l
Blood_God	l
BlueParrot	l
Brad	l
Bruce	l
bucko	l
Candle	w
cavehippo	l
Chloe	x
cmb	l
covbob	w
db_rat	l
Dirtus	w
Deejay	?
Dementia	w
Draconas	w
Faux	w
firefly	m
fred	l
frying_fish	l
icStatic	w
Inciner	w
Jeremy	l
Jingles	w
jonatan	l
Kegger	w
Kim	w
lamby	l
Laurence	l
lionfish	x
mulletron	l
Morlark	w
monk	l
murphy	w
Muz	w
Neko	w
NeXuS7	w
Nugent	m
Odd_Bloke	l
Penguin	w
PlanarPlatypus	l
Polar	l
sadiq	l
StrawberryUtopia	l
Sraphim	w
Sar	?
Skumby	w
Smile	?
speakfire	w
Socaddict	w
Sponge	w
Spooky_Rach	w
Silver	w
superdump	l
Tim	l
tom	l
Tortoise	w
Twinklefeet	w
tureklai	w
whythehell	l
Wiz	w
Yertle	w
Ynox	w
Zat	l
Zephran	w
zed0	x
Sinjo	w
Trip	w
Yurgen	m
zx64	x
Zwei	w

